α	ά
ά	ὰ
Ἀ	Ἄ
ἀ	ἄ
Ἁ	Ἅ
ἁ	ἅ
ᾳ	ᾴ
Ἄ	Ἂ
ἄ	ἂ
Ἅ	Ἃ
ἅ	ἃ
ᾈ	ᾌ
ᾀ	ᾄ
ᾉ	ᾍ
ᾁ	ᾅ
ᾌ	ᾊ
ᾄ	ᾂ
ᾍ	ᾋ
ᾅ	ᾃ
ᾊ	ᾊ
ε	έ
έ	ὲ
Ἐ	Ἔ
ἐ	ἔ
Ἑ	Ἕ
ἑ	ἕ
Ἔ	Ἒ
ἔ	ἒ
Ἕ	Ἓ
ἕ	ἓ
η	ή
ή	ὴ
Ἠ	Ἤ
ἠ	ἤ
Ἡ	Ἥ
ἡ	ἥ
ῃ	ῄ
Ἤ	Ἢ
ἤ	ἢ
Ἥ	Ἣ
ἥ	ἣ
ᾙ	ᾝ
ᾐ	ᾔ
ᾙ	ᾝ
ᾑ	ᾕ
ᾜ	ᾚ
ᾔ	ᾒ
ᾝ	ᾛ
ᾕ	ᾓ
ι	ί
ί	ὶ
ϊ	ΐ
ΐ	ῒ
Ἰ	Ἴ
ἰ	ἴ
Ἱ	Ἵ
ἱ	ἵ
Ἴ	Ἲ
ἴ	ἲ
Ἵ	Ἳ
ἵ	ἳ
ο	ό
ό	ὸ
Ὀ	Ὄ
ὀ	ὄ
Ὁ	Ὅ
ὁ	ὅ
Ὄ	Ὂ
ὄ	ὂ
Ὅ	Ὃ
ὅ	ὃ
υ	ύ
ύ	ὺ
ϋ	ΰ
ΰ	ῢ
ὐ	ὔ
ὔ	ὒ
Ὑ	Ὕ
ὑ	ὕ
Ὕ	Ὓ
ὕ	ὓ
Ὓ	Ὓ
ω	ώ
ώ	ὼ
Ὠ	Ὤ
ὠ	ὤ
Ὡ	Ὥ
ὡ	ὥ
ῳ	ῴ
Ὤ	Ὢ
ὤ	ὢ
Ὥ	Ὣ
ὥ	ὣ
ᾨ	ᾬ
ᾠ	ᾤ
ᾩ	ᾭ
ᾡ	ᾥ
ᾬ	Ὢ
ᾤ	ᾢ
ᾭ	ᾫ
ᾥ	ᾣ
